##########
#b  Xt  X#
#        #
#t  Cg p #
#    g   #
#   Pg # #
#  C   #C#
#  m  O# #
#  X   %E#
##########